Egg tubes are found inside the ovaries of an insect .	Where are egg tubes are found inside of an insect ?
Estonia is located in the Baltic region of Northern Europe .	Where is Estonia located in Northern Europe ?
The International Chopin Piano Competition is held in Warsaw .	Where is the International Chopin Piano Competition held ?
Chopin grew up in Warsaw .	Where did Chopin grow up ?
The Russians tried to resist Napoleon and got defeated in Smolensk .	Where did the Russians try to resist Napoleon and get defeated ?
The tracheae is located in the body cavity .	Where is tracheae located ?
Dragonflys shoot water from their rectal chamber .	Dragonflys shoot water from where ?
The kingdoms of Ba and Shu were located within the Sichuan Basin .	Where were the kingdoms of Ba and Shu located ?
The undergraduate women lived in Vanderbilt Hall during the first few years of women being allowed to attend Yale .	Where did undergraduate women live during the first few years of women being allowed to attend Yale ?
A lot of Germans settled between Susquehanna and Deleware Rivers .	Where did a lot of Germans settle ?
The Amtrak and Coaster trains primarily run along the coastline .	Where do the Amtrak and Coaster trains primarily run ?
In the US , it ends in Central Alabama .	Where does it end in the US ?
The fighting began in Ongjin peninsula .	Where did the fighting begin ?
Chopin and Sand moved to Square d'Orléans in 1842 .	In 1842 where did Chopin and Sand move ?
Ice starts accumulating in a glacier in Cirques .	Where does ice start accululating in a glacier ?
Sand 's home was Nohant .	Where was Sand 's home ?
Mesopotamian people originated from Sumer .	Where did the Mesopotamian people originate from ?
Napoleon 's wife and son went to Austria for shelter after he was exiled .	When Napoleon was exiled , where did his wife and son go for shelter ?
When Liszt lived close to Chopin , he called the Hôtel de France on the Rue Lafitte home .	When Liszt lived close to Chopin , where did he call home ?
An insects dry pellet is discarded through the anus .	Where is an insects dry pellet discarded through ?
The people of the region were noted in Classical literature .	Where were the people of the region noted ?
In eukaryotes , transcription occurs in the nucleus .	Where does transcription occur in eukaryotes ?
The traveled to Marseilles after leaving Barcelona .	Where did they travel after leaving Barcelona ?
The Chinese military deployed troops at the Korean border in preparation for the arrival of US troops .	Where did the Chinese military deploy troops in preparation for the arrival of US troops ?
The lateral moraines are found on the sides of the glacier .	Where are lateral moraines found ?
The word `` animal '' comes from the Latin word `` animalis '' .	Where does the word animal come from ?
Hanna Holborn Gray went to the University of Chicago after Yale .	Where did Hanna Holborn Gray go after Yale ?
Kerry 's paternal grandparents immigrated from the Austro-Hungarian Empire .	Where did Kerry 's paternal grandparents immigrate from ?
The second debate for presidency was held at Washington University in St. Louis , Missouri .	Where was the second debate for presidency held ?
The first fictionalized account of Chopin 's life was created in Milan .	Where was the first fictionalized account of Chopin 's life created ?
North Korea predicted that MacArthur would enter Korea at Incheon .	Where did North Korea predict that MacArthur would enter Korea ?
The capital of Korea was a factor in deciding where to divide the occupation zones .	What was a factor in deciding where to divide the occupation zones ?
One of the massacres occurred in Bissorã .	Where did one of the massacres occur ?
20.1 % percent of the population is born somewhere else in Switzerland .	What percent of the population is born somewhere else in Switzerland ?
The 24th Division was forced to retreat to Taejeon .	Where was the 24th Division forced to retreat to what location ?
The people of the Mail empire immigrated to the Grand Cape Mount region .	Where did the people of the Mali empire immigrate to ?
The majority of US naval patrols were to the west and east coasts of North Korea .	Where were the majority of US naval patrols of Korea ?
Mimicry complexes are usually found in Lepidoptera .	Mimicry complexes are usually found where ?
Facultative is the type of symbiotic relationship where the symbionts can live together but can also survive alone .	What is the type of symbiotic relationship where the symbionts can live together but can also survive alone ?
Chopin created most of his works in France .	Where did Chopin create most of his works ?
The fictionalized `` Chopin '' was produced in Milan .	Where was the fictionalized `` Chopin '' produced ?
The Eighth United States and ROK got pushed back to southeast Korea .	Where did the Eighth United States and ROK get pushed back to ?
Aside from when they 're speaking to Italians from their same town or region , at home with family is a common place where Italians speak their regional language .	Aside from when they 're speaking to Italians from their same town or region , where is a common place where Italians speak their regional language ?
Very Behind the Times is name of the episode where the newspaper , The Times , is featured and plays a central role in The Wombles .	What is the name of the episode where the newspaper , The Times , is featured and plays a central role in an episode of The Wombles ?
Last summer , Chopin was invited to Scotland .	Where was Chopin invited to in late summer ?
Chopin 's friends found him and apartment in Chaillot in 1849 .	Where did his friends found Chopin an apartment in 1849 ?
The Zahringer ruling family rose to power in Upper Burgundy .	Where did the Zahringer ruling family rise to power ?
Hennessy Scholars typically reside in the Wotton house .	Where do Hennessy Scholars typically reside ?
In Canada it starts in Newfoundland .	Where does it start in Canada ?
The 2010 Winter Olympics were held in Vancouver , Canada .	Where were the 2010 Winter Olympics held ?
